+-----------+------------------------------------+
|           |                                    |
| (closet)  |                                    |
|           |                                    |
|           |         (sleeping room)            |
|           |                                    |
|           |                                    |
+-----------+                                    |
|           |                                    |
|           |                                    |
|           |                                    |
|           +--------------+---------------------+
|                          |                     |
|                          |                     |
|                          |    (office)         |
|                          |                     |
+--------------+           |                     |
|              |           |                     |
| (toilet)     |           |                     |
|              |           |                     |
|              |           |                     |
+--------------+           +---------------------+
|              |           |                     |
|              |           |                     |
|              |           |                     |
| (bathroom)   |           |      (kitchen)      |
|              |           |                     |
|              |           |                     |
|              |           |                     |
|              +           |                     |
|             /            +---------------------+
|            /                                   |
|           /                                    |
|          /                                     |
+---------+                                      |
|                                                |
|                                                |
|                (living room)                   |
|                                                |
|                                                |
|                                                |
|                                                |
|                                                |
+--------------------------+---------------------+
                           |                     |
                           |                     |
                           |  (balcony)          |
                           |                     |
                           |                     |
                           +---------------------+