+-----------+------------------------------------+
|W          |                                   P|
| (closet)  |                                    |
|           |                                    |
|           |         P(sleeping room)P          |
|           |                                    |
|           |                                    |
+-----------+                                    |
|W         W|                                    |
|           |                                    |
|           |                                    |
|           +--------------+---------------------+
|                         P|                    S|
|                          |                     |
|                          |   W(office)W        |
|                          |                     |
+--------------+           |                     |
|              |           |                     |
| (toilet)     |           |                     |
|              |           |                     |
|              |           |                     |
+--------------+           +---------------------+
|              |           |                     |
|              |           |                     |
|              |           |                     |
| (bathroom)   |           |      (kitchen)      |
|              |           |                     |
|              |           |                     |
|              |           |                     |
|              +           |                     |
|            W/W           +---------------------+
|            /P                                 P|
|          S/S                                   |
|         C/                                     |
+---------+                                      |
|W                                               |
|                                                |
|                (living room)                   |
|                                                |
|                                                |
|                                                |
|                                                |
|W                                              S|
+--------------------------+---------------------+
                           |                     |
                           |                     |
                           |  (balcony)          |
                           |                     |
                           |                     |
                           +---------------------+